    NO  ./textures/bb.xpm
SO  ./textures/bb.xpm
WE  ./textures/bb.xpm
EA  ./textures/bb.xpm


F 220,100,0
C 225,30,0



1111111111111111111111111
1000000000110000000000001
1011000001110000000000001
100100000000000000000000111111111
111111111011000001110000000000001
100000000011000001110111111111111
111101111111110111000000100011111
1111011111111101  111101010010001
11000000110101011 111100000010001
100000000000000011000000100011111
10000000000000001101010010001
11000001110101011111011110N0111
11110111 1110101 101111010001
11111111 1111111 111111111111