NO textures-cub/11.xpm
SO textures-cub/11.xpm
WE textures-cub/2.xpm
EA textures-cub/3.xpm

F 75,55,35
C 105,90,70


        1111111111111111111111111
        1000000001100000000000011
        1011000001110000000000001  
        1010000000000000000000011
111111111011000001110000000000001
100000000011000001110111100001111
11110111111111011100000010001
11110111111111011101010010001
11000000110101011100000010001          
10000000000000001100000010001      
10000000000000001101010010001
1100001110101011111011110N0111
11110111 1110101 101111010001                           
11111111 1111111 111111111111                  


