NO  ./textures/colorstone.xpm
SO  ./textures/colorstone.xpm
WE  ./textures/colorstone.xpm
EA  ./textures/colorstone.xpm

F 0,0,100
C 0,100,0


        1111111111111111111111111
        1000000000110000000000001
111111111011000001110000000000001
100100000000000000000000111111111
111110000000000000000000000000001
111000000000000000000111111111111
111100000000000000000000000011111
111000000000000000000000000000001
111110000000000000000000000011111
11100000E000000000000000000011111
10000000000000001101010010001
1100000111010101111101111000111
11110111 1110101 101111010001
11111111 1111111 111111111111