    NO  ./textures/bb.xpm
SO  ./textures/bb.xpm
WE  ./textures/bb.xpm
EA  ./textures/bb.xpm


F 220,100,0
C 225,30,0


        1111111111111111111111111
        1011000001110000000000001
111111111001000000000000000000001
111111111011000001110000000000001
100000000011000001110111111111111
111101111111110111000000100011111
11110111111111011101010010001
11000000111101011100000010001
10000000000000001100000010001
10000000000000001101010010001
11000001110101011111011110P0111
11110111 1110101 101111010001
11111111 1111111 111111111111
