NO textures-cub/11.xpm
SO textures-cub/11.xpm
WE textures-cub/2.xpm
EA textures-cub/3.xpm 



F 75,55,35
C 75,      55        ,35
 

    1111111111111111111111111
    111111111111000000000000111
1111111111110000000000001111
1111100000000N0000001111111
111111111111111111111111111

