NO textures-cub/11.xpm
SO textures-cub/11.xpm
WE textures-cub/2.xpm
EA textures-cub/3.xpm



F 75,55,35
C 105,90,70


11111
10001
10S01
10001
10001
10001
11001
10001
10001
10001
10001
10001
 11111111

11111
111111111111111111
