NO  ./textures/1.xpm
SO  ./textures/1.xpm
WE  ./textures/1.xpm
EA  ./textures/1.xpm


C 1, 4, 6
F 1, 4, 6



1111111111111111111111111
1000000000110000000000001
1011000001110000000000001
100100000000000000000000111111111
111111111011000001110000000000001
100000000011000001110111111111111
111101111111110111000000100011111
111101111111110111111101010010001
110000001101010111111100000010001
1000N0000000000011000000100011111
10000000000000001101010010001
1100000111010101111101111000111
11110111 1110101 101111010001
11111111 1111111 111111111111